#pago;PagoIntereses;PagoCapital;SeguroVida;SeguroDaños;Comision;PagoHip;SeguroCasa;PagoTotal;SaldoCredito
Año;1
1;4,558.62;639.30;.00;123.15;290.00;5,611.07;.00;5,611.07;519,152.70
2;4,553.02;644.90;.00;123.15;290.00;5,611.07;.00;5,611.07;518,507.80
3;4,547.36;650.56;.00;123.15;290.00;5,611.07;.00;5,611.07;517,857.24
4;4,541.66;656.26;.00;123.15;290.00;5,611.07;.00;5,611.07;517,200.98
5;4,535.90;662.02;.00;123.15;290.00;5,611.07;.00;5,611.07;516,538.96
6;4,530.09;667.83;.00;123.15;290.00;5,611.07;.00;5,611.07;515,871.13
7;4,524.24;673.68;.00;123.15;290.00;5,611.07;.00;5,611.07;515,197.45
8;4,518.33;679.59;.00;123.15;290.00;5,611.07;.00;5,611.07;514,517.86
9;4,512.37;685.55;.00;123.15;290.00;5,611.07;.00;5,611.07;513,832.31
10;4,506.36;691.56;.00;123.15;290.00;5,611.07;.00;5,611.07;513,140.75
11;4,500.29;697.63;.00;123.15;290.00;5,611.07;.00;5,611.07;512,443.12
12;4,494.17;703.75;.00;123.15;290.00;5,611.07;.00;5,611.07;511,739.37
Año;2
13;4,488.00;709.92;.00;123.15;290.00;5,611.07;.00;5,611.07;511,029.45
14;4,481.78;716.14;.00;123.15;290.00;5,611.07;.00;5,611.07;510,313.31
15;4,475.49;722.43;.00;123.15;290.00;5,611.07;.00;5,611.07;509,590.88
16;4,469.16;728.76;.00;123.15;290.00;5,611.07;.00;5,611.07;508,862.12
17;4,462.77;735.15;.00;123.15;290.00;5,611.07;.00;5,611.07;508,126.97
18;4,456.32;741.60;.00;123.15;290.00;5,611.07;.00;5,611.07;507,385.37
19;4,449.82;748.10;.00;123.15;290.00;5,611.07;.00;5,611.07;506,637.27
20;4,443.26;754.66;.00;123.15;290.00;5,611.07;.00;5,611.07;505,882.60
21;4,436.64;761.28;.00;123.15;290.00;5,611.07;.00;5,611.07;505,121.32
22;4,429.96;767.96;.00;123.15;290.00;5,611.07;.00;5,611.07;504,353.36
23;4,423.23;774.69;.00;123.15;290.00;5,611.07;.00;5,611.07;503,578.67
24;4,416.43;781.49;.00;123.15;290.00;5,611.07;.00;5,611.07;502,797.18
Año;3
25;4,409.58;788.34;.00;123.15;290.00;5,611.07;.00;5,611.07;502,008.84
26;4,402.66;795.26;.00;123.15;290.00;5,611.07;.00;5,611.07;501,213.58
27;4,395.69;802.23;.00;123.15;290.00;5,611.07;.00;5,611.07;500,411.35
28;4,388.65;809.27;.00;123.15;290.00;5,611.07;.00;5,611.07;499,602.08
29;4,381.56;816.36;.00;123.15;290.00;5,611.07;.00;5,611.07;498,785.72
30;4,374.40;823.52;.00;123.15;290.00;5,611.07;.00;5,611.07;497,962.20
31;4,367.17;830.75;.00;123.15;290.00;5,611.07;.00;5,611.07;497,131.45
32;4,359.89;838.03;.00;123.15;290.00;5,611.07;.00;5,611.07;496,293.42
33;4,352.54;845.38;.00;123.15;290.00;5,611.07;.00;5,611.07;495,448.04
34;4,345.13;852.79;.00;123.15;290.00;5,611.07;.00;5,611.07;494,595.24
35;4,337.65;860.27;.00;123.15;290.00;5,611.07;.00;5,611.07;493,734.97
36;4,330.10;867.82;.00;123.15;290.00;5,611.07;.00;5,611.07;492,867.15
Año;4
37;4,322.49;875.43;.00;123.15;290.00;5,611.07;243.47;5,854.54;491,991.72
38;4,314.81;883.11;.00;123.15;290.00;5,611.07;243.47;5,854.54;491,108.61
39;4,307.07;890.85;.00;123.15;290.00;5,611.07;243.47;5,854.54;490,217.76
40;4,299.26;898.66;.00;123.15;290.00;5,611.07;243.47;5,854.54;489,319.10
41;4,291.37;906.55;.00;123.15;290.00;5,611.07;243.47;5,854.54;488,412.55
42;4,283.42;914.50;.00;123.15;290.00;5,611.07;243.47;5,854.54;487,498.05
43;4,275.40;922.52;.00;123.15;290.00;5,611.07;243.47;5,854.54;486,575.54
44;4,267.31;930.61;.00;123.15;290.00;5,611.07;243.47;5,854.54;485,644.93
45;4,259.15;938.77;.00;123.15;290.00;5,611.07;243.47;5,854.54;484,706.16
46;4,250.92;947.00;.00;123.15;290.00;5,611.07;243.47;5,854.54;483,759.16
47;4,242.61;955.31;.00;123.15;290.00;5,611.07;243.47;5,854.54;482,803.85
48;4,234.23;963.69;112.49;123.15;290.00;5,723.56;243.47;5,967.03;481,840.17
Año;5
49;4,225.78;972.14;112.27;123.15;290.00;5,723.34;243.47;5,966.81;480,868.03
50;4,217.26;980.66;112.04;123.15;290.00;5,723.11;243.47;5,966.58;479,887.37
51;4,208.66;989.26;111.81;123.15;290.00;5,722.88;243.47;5,966.35;478,898.10
52;4,199.98;997.94;111.58;123.15;290.00;5,722.65;243.47;5,966.12;477,900.16
53;4,191.23;1,006.69;111.35;123.15;290.00;5,722.42;243.47;5,965.89;476,893.47
54;4,182.40;1,015.52;111.12;123.15;290.00;5,722.19;243.47;5,965.66;475,877.95
55;4,173.49;1,024.43;110.88;123.15;290.00;5,721.95;243.47;5,965.42;474,853.52
56;4,164.51;1,033.41;110.64;123.15;290.00;5,721.71;243.47;5,965.18;473,820.11
57;4,155.45;1,042.47;110.40;123.15;290.00;5,721.47;243.47;5,964.94;472,777.64
58;4,146.30;1,051.62;110.16;123.15;290.00;5,721.23;243.47;5,964.70;471,726.02
59;4,137.08;1,060.84;109.91;123.15;290.00;5,720.98;243.47;5,964.45;470,665.18
60;4,127.78;1,070.14;109.66;123.15;290.00;5,720.73;243.47;5,964.20;469,595.04
Año;6
61;4,118.39;1,079.53;109.42;123.15;290.00;5,720.49;243.47;5,963.96;468,515.51
62;4,108.92;1,089.00;109.16;123.15;290.00;5,720.23;243.47;5,963.70;467,426.52
63;4,099.37;1,098.55;108.91;123.15;290.00;5,719.98;243.47;5,963.45;466,327.97
64;4,089.74;1,108.18;108.65;123.15;290.00;5,719.72;243.47;5,963.19;465,219.79
65;4,080.02;1,117.90;108.40;123.15;290.00;5,719.47;243.47;5,962.94;464,101.89
66;4,070.22;1,127.70;108.14;123.15;290.00;5,719.21;243.47;5,962.68;462,974.19
67;4,060.33;1,137.59;107.87;123.15;290.00;5,718.94;243.47;5,962.41;461,836.59
68;4,050.35;1,147.57;107.61;123.15;290.00;5,718.68;243.47;5,962.15;460,689.02
69;4,040.29;1,157.63;107.34;123.15;290.00;5,718.41;243.47;5,961.88;459,531.39
70;4,030.13;1,167.79;107.07;123.15;290.00;5,718.14;243.47;5,961.61;458,363.60
71;4,019.89;1,178.03;106.80;123.15;290.00;5,717.87;243.47;5,961.34;457,185.57
72;4,009.56;1,188.36;106.52;123.15;290.00;5,717.59;243.47;5,961.06;455,997.21
Año;7
73;3,999.14;1,198.78;106.25;123.15;290.00;5,717.32;243.47;5,960.79;454,798.43
74;3,988.62;1,209.30;105.97;123.15;290.00;5,717.04;243.47;5,960.51;453,589.13
75;3,978.02;1,219.90;105.69;123.15;290.00;5,716.76;243.47;5,960.23;452,369.23
76;3,967.32;1,230.60;105.40;123.15;290.00;5,716.47;243.47;5,959.94;451,138.63
77;3,956.53;1,241.39;105.12;123.15;290.00;5,716.19;243.47;5,959.66;449,897.24
78;3,945.64;1,252.28;104.83;123.15;290.00;5,715.90;243.47;5,959.37;448,644.96
79;3,934.66;1,263.26;104.53;123.15;290.00;5,715.60;243.47;5,959.07;447,381.70
80;3,923.58;1,274.34;104.24;123.15;290.00;5,715.31;243.47;5,958.78;446,107.36
81;3,912.40;1,285.52;103.94;123.15;290.00;5,715.01;243.47;5,958.48;444,821.84
82;3,901.13;1,296.79;103.64;123.15;290.00;5,714.71;243.47;5,958.18;443,525.05
83;3,889.76;1,308.16;103.34;123.15;290.00;5,714.41;243.47;5,957.88;442,216.89
84;3,878.28;1,319.64;103.04;123.15;290.00;5,714.11;243.47;5,957.58;440,897.25
Año;8
85;3,866.71;1,331.21;102.73;123.15;290.00;5,713.80;243.47;5,957.27;439,566.04
86;3,855.03;1,342.89;102.42;123.15;290.00;5,713.49;243.47;5,956.96;438,223.15
87;3,843.26;1,354.66;102.11;123.15;290.00;5,713.18;243.47;5,956.65;436,868.49
88;3,831.38;1,366.54;101.79;123.15;290.00;5,712.86;243.47;5,956.33;435,501.95
89;3,819.39;1,378.53;101.47;123.15;290.00;5,712.54;243.47;5,956.01;434,123.42
90;3,807.30;1,390.62;101.15;123.15;290.00;5,712.22;243.47;5,955.69;432,732.80
91;3,795.11;1,402.81;100.83;123.15;290.00;5,711.90;243.47;5,955.37;431,329.99
92;3,782.80;1,415.12;100.50;123.15;290.00;5,711.57;243.47;5,955.04;429,914.87
93;3,770.39;1,427.53;100.17;123.15;290.00;5,711.24;243.47;5,954.71;428,487.35
94;3,757.87;1,440.05;99.84;123.15;290.00;5,710.91;243.47;5,954.38;427,047.30
95;3,745.24;1,452.68;99.50;123.15;290.00;5,710.57;243.47;5,954.04;425,594.62
96;3,732.50;1,465.42;99.16;123.15;290.00;5,710.23;243.47;5,953.70;424,129.21
Año;9
97;3,719.65;1,478.27;98.82;123.15;290.00;5,709.89;243.47;5,953.36;422,650.94
98;3,706.69;1,491.23;98.48;123.15;290.00;5,709.55;243.47;5,953.02;421,159.71
99;3,693.61;1,504.31;98.13;123.15;290.00;5,709.20;243.47;5,952.67;419,655.40
100;3,680.42;1,517.50;97.78;123.15;290.00;5,708.85;243.47;5,952.32;418,137.89
101;3,667.11;1,530.81;97.43;123.15;290.00;5,708.50;243.47;5,951.97;416,607.08
102;3,653.68;1,544.24;97.07;123.15;290.00;5,708.14;243.47;5,951.61;415,062.84
103;3,640.14;1,557.78;96.71;123.15;290.00;5,707.78;243.47;5,951.25;413,505.06
104;3,626.48;1,571.44;96.35;123.15;290.00;5,707.42;243.47;5,950.89;411,933.62
105;3,612.70;1,585.22;95.98;123.15;290.00;5,707.05;243.47;5,950.52;410,348.40
106;3,598.79;1,599.13;95.61;123.15;290.00;5,706.68;243.47;5,950.15;408,749.27
107;3,584.77;1,613.15;95.24;123.15;290.00;5,706.31;243.47;5,949.78;407,136.12
108;3,570.62;1,627.30;94.86;123.15;290.00;5,705.93;243.47;5,949.40;405,508.82
Año;10
109;3,556.35;1,641.57;94.48;123.15;290.00;5,705.55;243.47;5,949.02;403,867.25
110;3,541.95;1,655.97;94.10;123.15;290.00;5,705.17;243.47;5,948.64;402,211.28
111;3,527.43;1,670.49;93.72;123.15;290.00;5,704.79;243.47;5,948.26;400,540.79
112;3,512.78;1,685.14;93.33;123.15;290.00;5,704.40;243.47;5,947.87;398,855.65
113;3,498.00;1,699.92;92.93;123.15;290.00;5,704.00;243.47;5,947.47;397,155.74
114;3,483.09;1,714.83;92.54;123.15;290.00;5,703.61;243.47;5,947.08;395,440.91
115;3,468.05;1,729.87;92.14;123.15;290.00;5,703.21;243.47;5,946.68;393,711.04
116;3,452.88;1,745.04;91.73;123.15;290.00;5,702.80;243.47;5,946.27;391,966.00
117;3,437.58;1,760.34;91.33;123.15;290.00;5,702.40;243.47;5,945.87;390,205.66
118;3,422.14;1,775.78;90.92;123.15;290.00;5,701.99;243.47;5,945.46;388,429.88
119;3,406.57;1,791.35;90.50;123.15;290.00;5,701.57;243.47;5,945.04;386,638.53
120;3,390.86;1,807.06;90.09;123.15;290.00;5,701.16;243.47;5,944.63;384,831.46
Año;11
121;3,375.01;1,822.91;89.67;123.15;290.00;5,700.74;243.47;5,944.21;383,008.55
122;3,359.02;1,838.90;89.24;123.15;290.00;5,700.31;243.47;5,943.78;381,169.65
123;3,342.89;1,855.03;88.81;123.15;290.00;5,699.88;243.47;5,943.35;379,314.62
124;3,326.62;1,871.30;88.38;123.15;290.00;5,699.45;243.47;5,942.92;377,443.33
125;3,310.21;1,887.71;87.94;123.15;290.00;5,699.01;243.47;5,942.48;375,555.62
126;3,293.66;1,904.26;87.50;123.15;290.00;5,698.57;243.47;5,942.04;373,651.36
127;3,276.96;1,920.96;87.06;123.15;290.00;5,698.13;243.47;5,941.60;371,730.40
128;3,260.11;1,937.81;86.61;123.15;290.00;5,697.68;243.47;5,941.15;369,792.59
129;3,243.12;1,954.80;86.16;123.15;290.00;5,697.23;243.47;5,940.70;367,837.78
130;3,225.97;1,971.95;85.71;123.15;290.00;5,696.78;243.47;5,940.25;365,865.83
131;3,208.68;1,989.24;85.25;123.15;290.00;5,696.32;243.47;5,939.79;363,876.59
132;3,191.23;2,006.69;84.78;123.15;290.00;5,695.85;243.47;5,939.32;361,869.90
Año;12
133;3,173.63;2,024.29;84.32;123.15;290.00;5,695.39;243.47;5,938.86;359,845.61
134;3,155.88;2,042.04;83.84;123.15;290.00;5,694.91;243.47;5,938.38;357,803.57
135;3,137.97;2,059.95;83.37;123.15;290.00;5,694.44;243.47;5,937.91;355,743.62
136;3,119.90;2,078.02;82.89;123.15;290.00;5,693.96;243.47;5,937.43;353,665.61
137;3,101.68;2,096.24;82.40;123.15;290.00;5,693.47;243.47;5,936.94;351,569.37
138;3,083.30;2,114.62;81.92;123.15;290.00;5,692.99;243.47;5,936.46;349,454.74
139;3,064.75;2,133.17;81.42;123.15;290.00;5,692.49;243.47;5,935.96;347,321.57
140;3,046.04;2,151.88;80.93;123.15;290.00;5,692.00;243.47;5,935.47;345,169.70
141;3,027.17;2,170.75;80.42;123.15;290.00;5,691.49;243.47;5,934.96;342,998.95
142;3,008.13;2,189.79;79.92;123.15;290.00;5,690.99;243.47;5,934.46;340,809.16
143;2,988.93;2,208.99;79.41;123.15;290.00;5,690.48;243.47;5,933.95;338,600.17
144;2,969.55;2,228.37;78.89;123.15;290.00;5,689.96;243.47;5,933.43;336,371.80
Año;13
145;2,950.01;2,247.91;78.37;123.15;290.00;5,689.44;243.47;5,932.91;334,123.89
146;2,930.30;2,267.62;77.85;123.15;290.00;5,688.92;243.47;5,932.39;331,856.27
147;2,910.41;2,287.51;77.32;123.15;290.00;5,688.39;243.47;5,931.86;329,568.76
148;2,890.35;2,307.57;76.79;123.15;290.00;5,687.86;243.47;5,931.33;327,261.19
149;2,870.11;2,327.81;76.25;123.15;290.00;5,687.32;243.47;5,930.79;324,933.38
150;2,849.70;2,348.22;75.71;123.15;290.00;5,686.78;243.47;5,930.25;322,585.16
151;2,829.10;2,368.82;75.16;123.15;290.00;5,686.23;243.47;5,929.70;320,216.34
152;2,808.33;2,389.59;74.61;123.15;290.00;5,685.68;243.47;5,929.15;317,826.74
153;2,787.37;2,410.55;74.05;123.15;290.00;5,685.12;243.47;5,928.59;315,416.19
154;2,766.23;2,431.69;73.49;123.15;290.00;5,684.56;243.47;5,928.03;312,984.50
155;2,744.90;2,453.02;72.93;123.15;290.00;5,684.00;243.47;5,927.47;310,531.49
156;2,723.39;2,474.53;72.35;123.15;290.00;5,683.42;243.47;5,926.89;308,056.96
Año;14
157;2,701.69;2,496.23;71.78;123.15;290.00;5,682.85;243.47;5,926.32;305,560.72
158;2,679.80;2,518.12;71.20;123.15;290.00;5,682.27;243.47;5,925.74;303,042.60
159;2,657.71;2,540.21;70.61;123.15;290.00;5,681.68;243.47;5,925.15;300,502.39
160;2,635.43;2,562.49;70.02;123.15;290.00;5,681.09;243.47;5,924.56;297,939.90
161;2,612.96;2,584.96;69.42;123.15;290.00;5,680.49;243.47;5,923.96;295,354.95
162;2,590.29;2,607.63;68.82;123.15;290.00;5,679.89;243.47;5,923.36;292,747.32
163;2,567.42;2,630.50;68.21;123.15;290.00;5,679.28;243.47;5,922.75;290,116.82
164;2,544.35;2,653.57;67.60;123.15;290.00;5,678.67;243.47;5,922.14;287,463.25
165;2,521.08;2,676.84;66.98;123.15;290.00;5,678.05;243.47;5,921.52;284,786.41
166;2,497.60;2,700.32;66.36;123.15;290.00;5,677.43;243.47;5,920.90;282,086.09
167;2,473.92;2,724.00;65.73;123.15;290.00;5,676.80;243.47;5,920.27;279,362.09
168;2,450.03;2,747.89;65.09;123.15;290.00;5,676.16;243.47;5,919.63;276,614.20
Año;15
169;2,425.93;2,771.99;64.45;123.15;290.00;5,675.52;243.47;5,918.99;273,842.21
170;2,401.62;2,796.30;63.81;123.15;290.00;5,674.88;243.47;5,918.35;271,045.92
171;2,377.10;2,820.82;63.15;123.15;290.00;5,674.22;243.47;5,917.69;268,225.09
172;2,352.36;2,845.56;62.50;123.15;290.00;5,673.57;243.47;5,917.04;265,379.53
173;2,327.40;2,870.52;61.83;123.15;290.00;5,672.90;243.47;5,916.37;262,509.02
174;2,302.23;2,895.69;61.16;123.15;290.00;5,672.23;243.47;5,915.70;259,613.32
175;2,276.83;2,921.09;60.49;123.15;290.00;5,671.56;243.47;5,915.03;256,692.24
176;2,251.21;2,946.71;59.81;123.15;290.00;5,670.88;243.47;5,914.35;253,745.53
177;2,225.37;2,972.55;59.12;123.15;290.00;5,670.19;243.47;5,913.66;250,772.98
178;2,199.30;2,998.62;58.43;123.15;290.00;5,669.50;243.47;5,912.97;247,774.37
179;2,173.00;3,024.92;57.73;123.15;290.00;5,668.80;243.47;5,912.27;244,749.45
180;2,146.48;3,051.44;57.03;123.15;290.00;5,668.10;243.47;5,911.57;241,698.01
Año;16
181;2,119.71;3,078.21;56.32;123.15;290.00;5,667.39;243.47;5,910.86;238,619.80
182;2,092.72;3,105.20;55.60;123.15;290.00;5,666.67;243.47;5,910.14;235,514.60
183;2,065.48;3,132.44;54.87;123.15;290.00;5,665.94;243.47;5,909.41;232,382.16
184;2,038.01;3,159.91;54.15;123.15;290.00;5,665.22;243.47;5,908.69;229,222.25
185;2,010.30;3,187.62;53.41;123.15;290.00;5,664.48;243.47;5,907.95;226,034.63
186;1,982.34;3,215.58;52.67;123.15;290.00;5,663.74;243.47;5,907.21;222,819.06
187;1,954.14;3,243.78;51.92;123.15;290.00;5,662.99;243.47;5,906.46;219,575.28
188;1,925.70;3,272.22;51.16;123.15;290.00;5,662.23;243.47;5,905.70;216,303.06
189;1,897.00;3,300.92;50.40;123.15;290.00;5,661.47;243.47;5,904.94;213,002.14
190;1,868.05;3,329.87;49.63;123.15;290.00;5,660.70;243.47;5,904.17;209,672.27
191;1,838.85;3,359.07;48.85;123.15;290.00;5,659.92;243.47;5,903.39;206,313.19
192;1,809.39;3,388.53;48.07;123.15;290.00;5,659.14;243.47;5,902.61;202,924.66
Año;17
193;1,779.67;3,418.25;47.28;123.15;290.00;5,658.35;243.47;5,901.82;199,506.40
194;1,749.69;3,448.23;46.48;123.15;290.00;5,657.55;243.47;5,901.02;196,058.17
195;1,719.45;3,478.47;45.68;123.15;290.00;5,656.75;243.47;5,900.22;192,579.70
196;1,688.94;3,508.98;44.87;123.15;290.00;5,655.94;243.47;5,899.41;189,070.72
197;1,658.17;3,539.75;44.05;123.15;290.00;5,655.12;243.47;5,898.59;185,530.97
198;1,627.12;3,570.80;43.23;123.15;290.00;5,654.30;243.47;5,897.77;181,960.18
199;1,595.81;3,602.11;42.40;123.15;290.00;5,653.47;243.47;5,896.94;178,358.06
200;1,564.22;3,633.70;41.56;123.15;290.00;5,652.63;243.47;5,896.10;174,724.36
201;1,532.35;3,665.57;40.71;123.15;290.00;5,651.78;243.47;5,895.25;171,058.79
202;1,500.20;3,697.72;39.86;123.15;290.00;5,650.93;243.47;5,894.40;167,361.07
203;1,467.77;3,730.15;39.00;123.15;290.00;5,650.07;243.47;5,893.54;163,630.92
204;1,435.06;3,762.86;38.13;123.15;290.00;5,649.20;243.47;5,892.67;159,868.06
Año;18
205;1,402.06;3,795.86;37.25;123.15;290.00;5,648.32;243.47;5,891.79;156,072.20
206;1,368.77;3,829.15;36.36;123.15;290.00;5,647.43;243.47;5,890.90;152,243.05
207;1,335.19;3,862.73;35.47;123.15;290.00;5,646.54;243.47;5,890.01;148,380.31
208;1,301.31;3,896.61;34.57;123.15;290.00;5,645.64;243.47;5,889.11;144,483.70
209;1,267.14;3,930.78;33.66;123.15;290.00;5,644.73;243.47;5,888.20;140,552.92
210;1,232.66;3,965.26;32.75;123.15;290.00;5,643.82;243.47;5,887.29;136,587.66
211;1,197.89;4,000.03;31.82;123.15;290.00;5,642.89;243.47;5,886.36;132,587.62
212;1,162.81;4,035.11;30.89;123.15;290.00;5,641.96;243.47;5,885.43;128,552.51
213;1,127.42;4,070.50;29.95;123.15;290.00;5,641.02;243.47;5,884.49;124,482.01
214;1,091.72;4,106.20;29.00;123.15;290.00;5,640.07;243.47;5,883.54;120,375.81
215;1,055.71;4,142.21;28.05;123.15;290.00;5,639.12;243.47;5,882.59;116,233.59
216;1,019.38;4,178.54;27.08;123.15;290.00;5,638.15;243.47;5,881.62;112,055.05
Año;19
217;982.73;4,215.19;26.11;123.15;290.00;5,637.18;243.47;5,880.65;107,839.86
218;945.77;4,252.15;25.13;123.15;290.00;5,636.20;243.47;5,879.67;103,587.71
219;908.47;4,289.45;24.14;123.15;290.00;5,635.21;243.47;5,878.68;99,298.26
220;870.85;4,327.07;23.14;123.15;290.00;5,634.21;243.47;5,877.68;94,971.20
221;832.91;4,365.01;22.13;123.15;290.00;5,633.20;243.47;5,876.67;90,606.19
222;794.62;4,403.30;21.11;123.15;290.00;5,632.18;243.47;5,875.65;86,202.89
223;756.01;4,441.91;20.09;123.15;290.00;5,631.16;243.47;5,874.63;81,760.98
224;717.05;4,480.87;19.05;123.15;290.00;5,630.12;243.47;5,873.59;77,280.11
225;677.75;4,520.17;18.01;123.15;290.00;5,629.08;243.47;5,872.55;72,759.94
226;638.11;4,559.81;16.95;123.15;290.00;5,628.02;243.47;5,871.49;68,200.13
227;598.12;4,599.80;15.89;123.15;290.00;5,626.96;243.47;5,870.43;63,600.34
228;557.78;4,640.14;14.82;123.15;290.00;5,625.89;243.47;5,869.36;58,960.20
Año;20
229;517.09;4,680.83;13.74;123.15;290.00;5,624.81;243.47;5,868.28;54,279.36
230;476.04;4,721.88;12.65;123.15;290.00;5,623.72;243.47;5,867.19;49,557.48
231;434.62;4,763.30;11.55;123.15;290.00;5,622.62;243.47;5,866.09;44,794.18
232;392.85;4,805.07;10.44;123.15;290.00;5,621.51;243.47;5,864.98;39,989.11
233;350.71;4,847.21;9.32;123.15;290.00;5,620.39;243.47;5,863.86;35,141.90
234;308.20;4,889.72;8.19;123.15;290.00;5,619.26;243.47;5,862.73;30,252.18
235;265.31;4,932.61;7.05;123.15;290.00;5,618.12;243.47;5,861.59;25,319.57
236;222.05;4,975.87;5.90;123.15;290.00;5,616.97;243.47;5,860.44;20,343.71
237;178.42;5,019.50;4.74;123.15;290.00;5,615.81;243.47;5,859.28;15,324.20
238;134.39;5,063.53;3.57;123.15;290.00;5,614.64;243.47;5,858.11;10,260.68
239;89.99;5,107.93;2.39;123.15;290.00;5,613.46;243.47;5,856.93;5,152.74
240;45.19;5,152.74;1.20;123.15;290.00;5,612.28;243.47;5,855.75;.00
